-#####----------
-#---####-------
-#---#--#---#---
-##----.####-###
###-###.#---#---
#-x-#-#.#-------
#-xx##-##-------
#S--#-----------
#####-----------